T T T T T T T T T T T T T T T T
T G G G T T T T T T T G G G T T
T G T G G G G G G G G G G G T T
T G G G G G G G G G G G G G T T
T G G T T T T T T T G G G G G G
T G G G T T G T T G G G G G G G
T G G G G G G G G G G G G G T T
T G G G G G G G G G G G G G T T
T T T T T T T T T T T T T T T T
T G T T T T T T G G T T T T T T
T G T T T T T G G T T T T T T T
T G G T T T T G G T T T T T T T
